[10 10]
[10 50 8]
[["floater" 10] ["blocker" 2]]
XXXXXXXXXX
XI       X
X..... . X
X        X
X    ... X
X     X  X
X     X  X
X     X  X
XO    .  X
XXXXXXXXXX
